9,4 7,4 10,2 9,2 8,2 5,2
4,4 5,2 3,2 2,2 4,1 6,1 9,4
10,1 11,1 12,1 11,1 10,2 10,1 11,1 10,1 9,1 8,1 7,1 10,4
9,1 10,1 11,1 10,1 9,2 8,1 9,1 10,1 11,1 12,1 13,1 9,4
10,2 9,2 10,1 9,1 8,2 7,1 8,1 9,2 6,2 7,1 8,1
2,1 3,1 4,1 5,1 6,1 7,1 8,1 11,1 10,4 _4
10,2 7,2 9,2 6,2 8,2 5,2 7,2 3,2
2,1 2,1 3,2 _2 2,1 2,1 4,2 _2 5,1 6,1 7,1 5,1
4,1 4,1 6,2 _2 4,1 4,1 8,2 _2 9,1 10,1 11,1 8,1
9,1 11,1 10,1 12,1 9,4 _4 _4