9,4 7,4 10,2 9,2 8,2 5,2
4,4 5,2 3,2 2,2 4,1 6,1 9,4
10,1 11,1 12,1 11,1 10,2 10,1 11,1 10,1 9,1 8,1 7,1 10,4
9,1 10,1 11,1 10,1 9,2 8,1 9,1 10,1 11,1 12,1 13,1 9,4
10,2 9,2 10,1 9,1 8,2 7,1 8,1 9,2 6,2 7,1 8,1
2,1 3,1 4,1 5,1 6,1 7,1 8,1 11,1 10,4 _4
10,2 7,2 9,2 6,2 8,2 5,2 7,2 3,2
2,1 2,1 3,2 _2 2,1 2,1 4,2 _2 5,1 6,1 7,1 5,1
4,1 4,1 6,2 _2 4,1 4,1 8,2 _2 9,1 10,1 11,1 8,1
9,1 11,1 10,1 12,1 9,4 _4 _4
11,1 12,1 13,2 _2 11,2 10,2 9,2 8,1 7,3
14,1 14,1 12,2 13,2 11,1 11,1 _1 12,1 10,1 8,1 9,1 10,1 11,1 13,1
12,3 11,1 10,3 11,1 12,1 13,1 14,2 14,2 10,2
7,4 7,1 7,1 7,1 8,1 9,4 10,1 10,1 11,1 12,1
9,2 10,2 11,2 9,2 8,2 9,2 10,2 8,2
7,4 _4 _2 7,1 7,1 7,4
8,2 7,1 7,1 6,2 5,2 4,2 1,2 _2 1,2
8,3 9,1 10,3 11,1 12,2 10,2 8,2 6,2
6,4 10,4 9,3 8,1 7,2 3,2
4,1 6,1 5,1 7,1 6,1 8,1 7,2 _2 6,1 8,1 9,1 10,1 11,2
11,4 8,2 10,4 9,4 8,1 9,1
6,1 8,1 7,1 9,1 8,1 11,1 10,2 _2 9,1 8,1 7,1 6,1 5,2
8,4 6,2 11,4 10,1 11,1 13,1 12,1 8,1 9,1
14,2 11,1 14,1 13,1 12,1 10,2 _2 9,1 8,1 4,1 3,1 5,1 4,1
8,2 15,2 15,2 7,1 6,1 5,1 5,1 12,2 12,2 7,1 8,1 